##################
#AAAAAAAAAAAAAAAA#
#AAAAAAAAAAAAAAAA#
#AAAAAAAAAAAAAAAA#
#AAAAAABBBAAAAAAA#
#AAAAAABBBAAAAAAA#
#AAAAAABBBAAAAAAA#
#AAAAAABBBAAAAAAA#
##################